10x10
##########
#P  T    #
# ###### #
#   T    #
## ####  #
#   #A   #
# # # ####
# T      #
#      S #
##########