30x10
##############################
#P T T T T     A     T T T  A#
# #########################  #
# #A         T         A    T#
# #  #########################
# #          T               #
# ########################## #
#                            #
# ######################### S#
##############################