20x15
####################
#P            T  T #
# ########    #    #
#    T             #
## ####        ### #
#    #A            #
# # # #### #####   #
# T                #
########     #     #
#A  ######    ### #
#                  #
#    #####  ##### ##
#  A A TTT         #
#                 S#
####################