10x30
##############################
#P   T   T   A   T           #
# # ############## ######### #
# #T#         #        #     #
# # # ####### # #####  # ### #
# # #       #   #      #T#   #
# #       # #     #        # #
# ####### # ##### #######  # #
#                           S#
##############################