15x20
####################
#P     T       T   #
# ###  ########### #
# #T#        #A#   #
# # #  ####### # # #
# # #  ### ### ### #
# # #     #      # #
# # # #  # # ### # #
#   # #          # #
### # #  # # ##### #
#   # # # # T      #
# # # # # ###  ### #
# #   # A      #   #
#     T           S#
####################